################
#              #
#     C@   X  G#
#  ooooo########
#      s       #
#            ss#
#        s  #ss#
#           #ss#
#           #ss#
#          L#ss#
#           #ss#
#           #ss#
#           #dd#
#        ####dd#
#V       #ddddV#
################
